7 5
5 0
- - - - -
- - + - -
- ? + M -
- + + - -
- - - - -
- - - - -
- - - - ?
